NO ./assets/sprites/bluestone.xpm
SO ./assets/sprites/greystone.xpm
WE ./assets/sprites/purplestone.xpm
EA ./assets/sprites/redbrick.xpm
WL ./assets/sprites/0.xpm

F 39,127,193
C 239,220,69

        1111111111111111111111111
        1000000000110000000000001
        1011000001110000000000001
        1001000000020000000000001
111111111011000001110000000000001
100000000011000001112111110111111
11110111111111011100000010001
11110111111111011101010010001
11000000110101011100000010001
10000000000000001100000010001
10000000000000001101010010001
11000001110101011111011110W01
11110111 1110101 101111010001
11111111 1111111 111111111111
